"filename", "language", "Makefile", "C++", "Markdown", "YACC", "comment", "blank", "total"
"c:\Users\RUBY\Desktop\Compile_design\Makefile", "Makefile", 28, 0, 0, 0, 0, 9, 37
"c:\Users\RUBY\Desktop\Compile_design\README.md", "Markdown", 0, 0, 11, 0, 0, 2, 13
"c:\Users\RUBY\Desktop\Compile_design\bin\Yacc\y.tab.h", "C++", 0, 1207, 0, 0, 3, 6, 1216
"c:\Users\RUBY\Desktop\Compile_design\bin\Yacc\yacc.y", "YACC", 0, 0, 0, 394, 0, 78, 472
"c:\Users\RUBY\Desktop\Compile_design\bin\test\y.tab.h", "C++", 0, 1207, 0, 0, 3, 6, 1216
"c:\Users\RUBY\Desktop\Compile_design\comprehensiveDesign.md", "Markdown", 0, 0, 151, 0, 0, 22, 173
"c:\Users\RUBY\Desktop\Compile_design\src\SeuLex\bin\11\lex.yy.cpp", "C++", 0, 901, 0, 0, 21, 78, 1000
"c:\Users\RUBY\Desktop\Compile_design\src\SeuLex\bin\11\main.cpp", "C++", 0, 26, 0, 0, 1, 1, 28
"c:\Users\RUBY\Desktop\Compile_design\src\SeuLex\bin\11\y.tab.cpp", "C++", 0, 3207, 0, 0, 5, 2520, 5732
"c:\Users\RUBY\Desktop\Compile_design\src\SeuLex\bin\11\y.tab.h", "C++", 0, 172, 0, 0, 3, 11, 186
"c:\Users\RUBY\Desktop\Compile_design\src\SeuLex\bin\lex.yy.cpp", "C++", 0, 893, 0, 0, 21, 81, 995
"c:\Users\RUBY\Desktop\Compile_design\src\SeuLex\bin\teet2\lex.yy.cpp", "C++", 0, 1139, 0, 0, 1, 62, 1202
"c:\Users\RUBY\Desktop\Compile_design\src\SeuLex\bin\test.cpp", "C++", 0, 11, 0, 0, 0, 4, 15
"c:\Users\RUBY\Desktop\Compile_design\src\SeuLex\bin\test\lex.yy.cpp", "C++", 0, 159, 0, 0, 1, 26, 186
"c:\Users\RUBY\Desktop\Compile_design\src\SeuLex\bin\未命名1.cpp", "C++", 0, 10, 0, 0, 0, 3, 13
"c:\Users\RUBY\Desktop\Compile_design\src\SeuLex\dev\LexException.hpp", "C++", 0, 0, 0, 0, 11, 0, 11
"c:\Users\RUBY\Desktop\Compile_design\src\SeuLex\dev\NFA_backup2.hpp", "C++", 0, 301, 0, 0, 62, 22, 385
"c:\Users\RUBY\Desktop\Compile_design\src\SeuLex\dev\RE.cpp", "C++", 0, 0, 0, 0, 0, 1, 1
"c:\Users\RUBY\Desktop\Compile_design\src\SeuLex\dev\RE.hpp", "C++", 0, 280, 0, 0, 12, 8, 300
"c:\Users\RUBY\Desktop\Compile_design\src\SeuLex\dev\visualFA.cpp", "C++", 0, 27, 0, 0, 2, 4, 33
"c:\Users\RUBY\Desktop\Compile_design\src\SeuLex\include\CONSTANT.h", "C++", 0, 15, 0, 0, 5, 8, 28
"c:\Users\RUBY\Desktop\Compile_design\src\SeuLex\include\DFA.h", "C++", 0, 50, 0, 0, 2, 2, 54
"c:\Users\RUBY\Desktop\Compile_design\src\SeuLex\include\DFA_Node.hpp", "C++", 0, 97, 0, 0, 4, 7, 108
"c:\Users\RUBY\Desktop\Compile_design\src\SeuLex\include\DataStruct.h", "C++", 0, 0, 0, 0, 0, 1, 1
"c:\Users\RUBY\Desktop\Compile_design\src\SeuLex\include\Hash.hpp", "C++", 0, 108, 0, 0, 84, 11, 203
"c:\Users\RUBY\Desktop\Compile_design\src\SeuLex\include\Lex.h", "C++", 0, 75, 0, 0, 8, 20, 103
"c:\Users\RUBY\Desktop\Compile_design\src\SeuLex\include\Logger.h", "C++", 0, 25, 0, 0, 19, 6, 50
"c:\Users\RUBY\Desktop\Compile_design\src\SeuLex\include\NFA.h", "C++", 0, 149, 0, 0, 1, 6, 156
"c:\Users\RUBY\Desktop\Compile_design\src\SeuLex\include\NFA_Cluster.h", "C++", 0, 33, 0, 0, 37, 5, 75
"c:\Users\RUBY\Desktop\Compile_design\src\SeuLex\include\NFA_eclosure.h", "C++", 0, 27, 0, 0, 1, 5, 33
"c:\Users\RUBY\Desktop\Compile_design\src\SeuLex\include\RE.h", "C++", 0, 24, 0, 0, 10, 12, 46
"c:\Users\RUBY\Desktop\Compile_design\src\SeuLex\include\action.hpp", "C++", 0, 36, 0, 0, 0, 2, 38
"c:\Users\RUBY\Desktop\Compile_design\src\SeuLex\include\basicFA.hpp", "C++", 0, 28, 0, 0, 0, 1, 29
"c:\Users\RUBY\Desktop\Compile_design\src\SeuLex\include\graph.h", "C++", 0, 115, 0, 0, 9, 5, 129
"c:\Users\RUBY\Desktop\Compile_design\src\SeuLex\include\semaphore.h", "C++", 0, 30, 0, 0, 4, 2, 36
"c:\Users\RUBY\Desktop\Compile_design\src\SeuLex\include\threadpool.hpp", "C++", 0, 125, 0, 0, 24, 9, 158
"c:\Users\RUBY\Desktop\Compile_design\src\SeuLex\include\visualFA.hpp", "C++", 0, 86, 0, 0, 2, 11, 99
"c:\Users\RUBY\Desktop\Compile_design\src\SeuLex\src\DFA.cpp", "C++", 0, 545, 0, 0, 21, 31, 597
"c:\Users\RUBY\Desktop\Compile_design\src\SeuLex\src\Lex.cpp", "C++", 0, 643, 0, 0, 54, 36, 733
"c:\Users\RUBY\Desktop\Compile_design\src\SeuLex\src\Logger.cpp", "C++", 0, 89, 0, 0, 10, 11, 110
"c:\Users\RUBY\Desktop\Compile_design\src\SeuLex\src\NFA.cpp", "C++", 0, 40, 0, 0, 1, 8, 49
"c:\Users\RUBY\Desktop\Compile_design\src\SeuLex\src\NFA_Cluster.cpp", "C++", 0, 536, 0, 0, 68, 22, 626
"c:\Users\RUBY\Desktop\Compile_design\src\SeuLex\src\NFA_eclosure.cpp", "C++", 0, 73, 0, 0, 1, 6, 80
"c:\Users\RUBY\Desktop\Compile_design\src\SeuLex\src\RE.cpp", "C++", 0, 273, 0, 0, 184, 16, 473
"c:\Users\RUBY\Desktop\Compile_design\src\SeuLex\src\main.cpp", "C++", 0, 54, 0, 0, 0, 3, 57
"c:\Users\RUBY\Desktop\Compile_design\src\SeuYacc\bin\YaccFileParsing.cpp", "C++", 0, 166, 0, 0, 35, 43, 244
"c:\Users\RUBY\Desktop\Compile_design\src\SeuYacc\bin\YaccFileParsing.h", "C++", 0, 7, 0, 0, 10, 4, 21
"c:\Users\RUBY\Desktop\Compile_design\src\SeuYacc\bin\caculator\cal.y", "YACC", 0, 0, 0, 77, 0, 15, 92
"c:\Users\RUBY\Desktop\Compile_design\src\SeuYacc\bin\caculator\lex.yy.cpp", "C++", 0, 158, 0, 0, 1, 12, 171
"c:\Users\RUBY\Desktop\Compile_design\src\SeuYacc\bin\caculator\y.tab.cpp", "C++", 0, 672, 0, 0, 5, 306, 983
"c:\Users\RUBY\Desktop\Compile_design\src\SeuYacc\bin\caculator\y.tab.h", "C++", 0, 42, 0, 0, 3, 8, 53
"c:\Users\RUBY\Desktop\Compile_design\src\SeuYacc\bin\new yacc\test.cpp", "C++", 0, 94, 0, 0, 13, 12, 119
"c:\Users\RUBY\Desktop\Compile_design\src\SeuYacc\bin\new yacc\test2.cpp", "C++", 0, 12, 0, 0, 0, 1, 13
"c:\Users\RUBY\Desktop\Compile_design\src\SeuYacc\bin\new yacc\y.cpp", "C++", 0, 247, 0, 0, 7, 19, 273
"c:\Users\RUBY\Desktop\Compile_design\src\SeuYacc\bin\new yacc\y.tab.h", "C++", 0, 1207, 0, 0, 3, 6, 1216
"c:\Users\RUBY\Desktop\Compile_design\src\SeuYacc\bin\testing\y.tab.h", "C++", 0, 1207, 0, 0, 3, 6, 1216
"c:\Users\RUBY\Desktop\Compile_design\src\SeuYacc\bin\y.tab.cpp", "C++", 0, 3206, 0, 0, 5, 2520, 5731
"c:\Users\RUBY\Desktop\Compile_design\src\SeuYacc\bin\y.tab.h", "C++", 0, 167, 0, 0, 3, 10, 180
"c:\Users\RUBY\Desktop\Compile_design\src\SeuYacc\bin\yacc - 副本.y", "YACC", 0, 0, 0, 394, 0, 78, 472
"c:\Users\RUBY\Desktop\Compile_design\src\SeuYacc\bin\yacc.y", "YACC", 0, 0, 0, 394, 0, 78, 472
"c:\Users\RUBY\Desktop\Compile_design\src\SeuYacc\include\CONSTANT.h", "C++", 0, 9, 0, 0, 2, 5, 16
"c:\Users\RUBY\Desktop\Compile_design\src\SeuYacc\include\DataStructure.h", "C++", 0, 49, 0, 0, 25, 20, 94
"c:\Users\RUBY\Desktop\Compile_design\src\SeuYacc\include\First.h", "C++", 0, 9, 0, 0, 5, 12, 26
"c:\Users\RUBY\Desktop\Compile_design\src\SeuYacc\include\Hash.hpp", "C++", 0, 102, 0, 0, 20, 5, 127
"c:\Users\RUBY\Desktop\Compile_design\src\SeuYacc\include\LR.h", "C++", 0, 37, 0, 0, 68, 8, 113
"c:\Users\RUBY\Desktop\Compile_design\src\SeuYacc\include\LR_Node.h", "C++", 0, 67, 0, 0, 81, 9, 157
"c:\Users\RUBY\Desktop\Compile_design\src\SeuYacc\include\LR_Producer.hpp", "C++", 0, 75, 0, 0, 74, 4, 153
"c:\Users\RUBY\Desktop\Compile_design\src\SeuYacc\include\Logger.h", "C++", 0, 25, 0, 0, 19, 6, 50
"c:\Users\RUBY\Desktop\Compile_design\src\SeuYacc\include\Transform.h", "C++", 0, 7, 0, 0, 8, 5, 20
"c:\Users\RUBY\Desktop\Compile_design\src\SeuYacc\include\YaccFileParsing.h", "C++", 0, 7, 0, 0, 10, 4, 21
"c:\Users\RUBY\Desktop\Compile_design\src\SeuYacc\include\basicFA.hpp", "C++", 0, 23, 0, 0, 0, 4, 27
"c:\Users\RUBY\Desktop\Compile_design\src\SeuYacc\include\graph.h", "C++", 0, 115, 0, 0, 9, 5, 129
"c:\Users\RUBY\Desktop\Compile_design\src\SeuYacc\include\header.h", "C++", 0, 18, 0, 0, 1, 3, 22
"c:\Users\RUBY\Desktop\Compile_design\src\SeuYacc\include\visualLR.h", "C++", 0, 19, 0, 0, 1, 12, 32
"c:\Users\RUBY\Desktop\Compile_design\src\SeuYacc\include\yacc.y", "YACC", 0, 0, 0, 49, 0, 10, 59
"c:\Users\RUBY\Desktop\Compile_design\src\SeuYacc\src\DataStructure.cpp", "C++", 0, 384, 0, 0, 30, 32, 446
"c:\Users\RUBY\Desktop\Compile_design\src\SeuYacc\src\First.cpp", "C++", 0, 179, 0, 0, 43, 31, 253
"c:\Users\RUBY\Desktop\Compile_design\src\SeuYacc\src\LR.cpp", "C++", 0, 400, 0, 0, 48, 36, 484
"c:\Users\RUBY\Desktop\Compile_design\src\SeuYacc\src\LR_Node.cpp", "C++", 0, 151, 0, 0, 1, 11, 163
"c:\Users\RUBY\Desktop\Compile_design\src\SeuYacc\src\Logger.cpp", "C++", 0, 89, 0, 0, 10, 11, 110
"c:\Users\RUBY\Desktop\Compile_design\src\SeuYacc\src\SeuYacc.cpp", "C++", 0, 112, 0, 0, 54, 17, 183
"c:\Users\RUBY\Desktop\Compile_design\src\SeuYacc\src\Transform.cpp", "C++", 0, 83, 0, 0, 16, 22, 121
"c:\Users\RUBY\Desktop\Compile_design\src\SeuYacc\src\YaccFileParsing.cpp", "C++", 0, 289, 0, 0, 102, 43, 434
"c:\Users\RUBY\Desktop\Compile_design\src\SeuYacc\src\visualLR.cpp", "C++", 0, 55, 0, 0, 1, 11, 67
"Total", "-", 28, 22305, 162, 1308, 1411, 6634, 31848